TITLE;
Author;
width;
height;
11111111111111;
18000000000051;
10000000000051;
11111111111051;
10000000000051;
10000000000051;
10011111111111;
10010000000001;
10010000000001;
10010005100001;
10010005100001;
10000005100901;
10000005100001;
11111111111111

----
0-background
1-wall
3-spikes (facing right)
4-spikes (facing up)
5-spikes (facing left)
6-spikes (facing down)
8-ball
9-hole